const short pitfall_demo_map_01_map[12][16] = {
{ 149, 137, 145, 140, 142, 43, 43, 43, 43, 43, 43, 43, 43, 43, 43, 43
 },
{ 43, 136, 146, 136, 136, 43, 43, 43, 43, 43, 43, 43, 43, 43, 43, 43
 },
{ 17, 18, 19, 20, 21, 22, 23, 24, 25, 26, 27, 28, 29, 30, 31, 42
 },
{ 34, 35, 42, 42, 38, 42, 42, 42, 42, 42, 44, 42, 42, 47, 42, 42
 },
{ 51, 52, 42, 42, 55, 42, 42, 42, 42, 42, 61, 42, 42, 64, 42, 42
 },
{ 34, 35, 42, 42, 55, 42, 42, 42, 42, 42, 61, 42, 42, 47, 42, 42
 },
{ 36, 36, 36, 36, 36, 36, 37, 36, 36, 36, 36, 36, 36, 36, 36, 36
 },
{ 56, 56, 56, 56, 56, 56, 0, 56, 56, 56, 56, 56, 56, 56, 56, 56
 },
{ 0, 41, 0, 0, 0, 0, 0, 0, 0, 0, 0, 0, 0, 0, 0, 0
 },
{ 0, 41, 0, 0, 0, 0, 0, 0, 0, 0, 0, 0, 0, 0, 0, 0
 },
{ 0, 41, 0, 0, 0, 0, 0, 0, 0, 0, 0, 0, 0, 0, 0, 0
 },
{ 39, 39, 39, 39, 39, 39, 39, 39, 39, 39, 39, 39, 39, 39, 39, 39
 }
};

